XXXXXXXXXXXXXXXXXXXXX.X...............XXX##XXXXXXXXXXXXXXXXXXXXXXXXXX...............XXXXXXXXXXXXXXX.
XXXXXXXXXXXXXXXXXXXXXX##................X##XXXXXXX.X.XXXXXXXXXXXXX....................XXXXXXXXXXXXX.
XXXXXXXXXXXXXXXXXXXXXX##.................##XXX.XX......................................XXX######XXX.
XXXXXXXXXXXXXXXXXXXXXX##.................##.............................................XX######XXXX
XXXXXXXXXXXXXXXXXXXXXX##.................##...............................................##....XXXX
XXXXXXXXXXXXXXXXXXXXXX##.................##........................................##.....##....XX..
XXXXXXXXXXXXXXXXXXXXXX##...........................................................##.....##....XX..
XXXXXXXXXXXXXXXXXXXXXXX....................................................######..##.....##........
XXXXXXXXXXXXXXXXXXXXXX##...................................................######..##.....##........
XXXXXXXXXXXXXXXXXXXXXX##...........................................................##...............
XXXXXXXXXXXXXXXXXXXXX.##...........................................................##....##.........
XXXXXXXXXXXXXXXXXXXX..##.................................................................##.........
######XXXXXXXXXXXX....##.........................................######..................##.........
######XXXXXXXXXXXX....##.........................................######..................##.........
XXXXXXXXXXXXXXXXX..........................................##............................##.........
XXXXXXXXXXXXXXXX...................X..XXX.XXXX...X.XXXXXX..##X...........................##.........
XXXXXXXXXXXXXXX..........######..XXXXXXXXXX.XXXXXXXXXXXXXXX##.......XX..XXXXXX.XX........##.........
XXXXXXXXXXXXXXX..........######.XXXXXXXXXXXXXXXXXXXXXXXXXXX##X.....X.XXXXXXXXX######.....##.........
XXXXXXXXXXXX..######............XXXXXXXX##XXXXXXXXXXXXXXXXX##X....X.XXXXXXXXXX######.....##.........
.######XXXX...######............##XXXXXX##XXXXXXXXXXXXXXXXX##X.....XXXXXXXXXXXXXXXXXXX...##.........
.######.........................##XXXXXX##XX######XXXXXXXXXXXX.....XXXXXXXXXXXXXX######.............
.........................A3.....##XXXXXX##XX######XXXXXXXXXXXX....XXXXXXXXXXXXXXX######.######......
..........................333...##.XXXXX##XXXXXXXXXXXXXXXXXXXX....XXXXX######XXXXXXXXX..######......
............................3333##XXXXXX##XXXXXXXXXXXXXXXXXXXX.....XXXX######XXXXXXXX.X.............
...............................3##XXXXXXXXXXXXXXXXXXXXXXXXXXXXXXX.##XXXXXXXXXXXXXXXXXXX.............
...............................33.XX.XXXXXXXXXXXXXXXXXXXXXXXXXXXX.##XXXXXXXXXXXXXXXXX..######.......
........##......................3333333.XXXXXXXXXXXXXXXXXXXXXXXXXX##XXXXXXXXXXXXXXXXX..######.......
........##............................33XXXXXXXXXXXXXXXXXXXXXXXXXX##.XXXXXXXXXXXXXXXX...............
........##.............................3X.XXXXXXXXXXXXXXXXXXXXXXXX##XXXXXXXXXXXXXXXXXXXXX..XX.......
........##.............................333XXXXXXXXXXXXXXXXXXXXXXXX##XXXXXXXXXXXXXXXXXXXX.X..........
..##....##...............................333333333333333A##XXXXXXXXXXXXXXXXXXXXXXXXXXXXXXXXXXX......
..##....##................................XXXXXXXXXXXXXXX##XXXXXXXXXXXXXXXXXXXXX######XXXXXXX.......
..##......................................XXXXXXXXXXXXXXX##XXXXXXXXXXXXXXXXXXXXX######XXXXXX.XXX....
..##.......................................XXXXXXXXXXXXXX##XXXXXXXXXXXXXXXXXXXXXXXXXXXXXXXXXXXX.X...
..##......................................X.XXXXXXXXXXXXX##XXXXXXXXXXXXXXXXXXXXXXXXXXXXXXXXXXXXXX...
..##...............X.X.X.XXXXX.XX..........XXXXXXXXXXXXXX##XXXXXXXXXXXXXXXXXXXXXXXXXXXXXXXXXXXXXXX..
.................XXXXXXXXXXXXXXX...........XXXXXXXXXXXXXXXXXXXXXXXXXXXXXXXXXXXXXXXXXXXXXXXXXXXXXX...
.................XXXXXXXXXXXXXXXX...........XXXXXXXXXXXXXXXXXXXXXXXXXXXXXXXXXXXXXXXXXXXXXXXXXXXXXX..
.................XXXXXXXXXXXXXXXX...........XXXXXXXXXX##XXXXXXXXXXXXXXXXXXXXXXXXXXXXXXXXXXXXXXXXXX..
..................XXXXXXXXXXXXXXXX..........XXXXXXXXXX##XXXXXXXXXXXXXXXXXXXXXXXXXXXXXXXXXXXXXXXXXX..
................XXXXXXXXXXXXXXXXXXX.........XXXXXXXXXX##XXXXXXXXXXXXXXXX##XXXXXXXXXXXXXXXXXXXXXXXXX.
................XXXXXXXXXXXXXXXXXXXXX.X..X...XXXXXXXXX##XXXXXXXXXXXXXXXX##XXXXXXXXXXXXXXXXXXXXXXXXX.
XXXX......##....XXXXXXXXXXXXXXXXXXXXXXXXX.X...XXXXXXXX##XXXXXXXXXXXXXXXX##XXXXX.XXXXXXXXXXXXXXXXXXX.
XX.XX.....##......XXXXXXXXXXXXXXXXXXXXXXXX.X.....XXXXX##XXXXXXXXXXXXXXXX##XXXXXXXXXXXXXXXXXXXXXXXXX.
XXXXX.X...##.....X.XXXXXXXXXXXXXXXXXXXXXXXXXXX....XXXXXXXXXXXXXXXXXXXXXX##XXXXXXXXXXXXXXXXXXXXXXXXX.
XXXXXXX...##.....XXXXXXXXXXXXXXXXXXXXXXXXXXXXXX...XXXXXXXXXXXXXXXXXXXXXX##XXXXXXXXXXXXXXXXXXXXXXXXX.
XXXXXXX...##.....XXXXXXXXXXXXXXXXXXXXXXXXXXXX.X...X..XXXXXXXXXXXXXXXXXXXXXXXXXXXXXXXXXXXXXXXXXXXXXX.
XXXXXXX...##.....##XXXXXXXXXXXXXXXXXXXXXXXXXXX.....XXXXXXXXXXXXXXXXXXXXXXXXXXXXXXXXXXXXXXXXXXXXXXXX.
XXXXX...........X##XXXXXXXXXXXXXXXXXXXXXXXXXXXXXX.XXXXXXXXXXX##XXXXXXXXXXXXXXXXXXXXXXXXXXXXXXXX.XXX.
XXXXXXX...######X##XXXXXXXXXXXXXXXXXXXXXXXXXXXXXXXXXXXXXXXXXX##XXXXXXXXXXXXXXXXXXXXXXXXXXXXXXXX.XXX.
XXXXXX....######X##XXXXXXXXXXXXXXXXXXXXXXXXXXXXXXXXXX##XXXXXX##XXXXXXXXXXXXXXXXXXXXXXXXXXXXXXXX.XX..
XXXXXXX........XX##XXXXXXXXXXXXXXXXXXXXXXXXXXXXXXXXXX##XXXXXX##XXXXXXXXXXXXXXXXXXXXXXXXXXXXXXXXXX...
XXXXXXX.........X##XXXXXXXXXXXXXXXXXXXXXXXXXXXXXXXXXX##XXXXXX##XXXXXXXXXXX##XXXXXXXXXXXXXXXXXXXXX.X.
XXXXXX..........XXXXXXXXXXXXXXXXXXXXXXXXXXXXXXXXXXXXX##XXXXXX##XXXXXXXXXXX##XXXXXXXXXXXXXXXXXXXXXX..
XXXXXX...........XXXXXXXXXXXXXXXXXXXXXXXXXXXXXXXXXXXX##XXXXXXXXXXXXXXXXXXX##XXXXXXXXXXXXXXXXX##XXXX.
XXXXXXX.........X.XXXXXXXXXXXXXXXXXXXXXXXXXXXXXXXXXXX##XXXXXXXXXXXXXXXXXXX##XXXXXXXXXXXXXXXXX##XXXX.
XXXXXXX............X.XXXXXXXXXXXXXXXXXXXXXXXXXXXXXXXXXXXXXXXXXXXXXXXXXXXXX##XXXXXX.XXXXXXXXXX##XXXXX
XXXXXXX................XXXXX######XXXXXXXXXXXXXXXXXXXXXXXXXXXXXXXXXXXXXXXX##XXXXX...XXXXXXXXX##XXXX.
XXXXXX..................X.XX######XXXXXXXXXXXXXXXXXXXXXXXXXXXXXXXXXXXXXXX.....######XXXXXXXXX##XXXXX
XXXXXXX..................XXXXXXXXXXXXXXXXXXXXXXXXXXXXXXXXXXXXXXXXXXXXXXX......######..X.XXXXX##XXXXX
XXXXXX..................X.XXXXXXXXXXXXXXXXXXXXXXXXXXXXXXXXXXXXXXXXXXXXXX..............XXXXXXXXXXXXXX
XXXXXXX...................XXXXXXXXXXXXXXXXXXXXX..XXXXXXXXXXXXXXXXXXXXXX..............XXXXXXXXXXXXXX.
XXXXXX..............######.XXXXXXXXXXXXXXXXXXXXXXXXXXXXXXXXXXXXXXXXXXX....................XXXXXXXXX.
XXXXXXX.............######.XXXXXXXXXXXXXXXXX##XXXXXXXXXXXXXXXXXXXXXXXX..........................XX..
XXXXXX......................XXXXXXXXXXXXXXXX##XXXXXXXXXXXXXXXXXXXXXX............................X.X.
XXXXX.......................X.XXXXXXXXXXXXXX##XXXXXXXXX.X.XXXXXX.XX.............................X.X.
XX......................XXXXXXXXXXXXXXXXXXXX##XXXXXXX.X..XXXXXXX....................................
.................XXX.XXXXXXXXXXXXXXXXXXXXXXX##XXXXXXX...............................................
..................XXXXXXXXXXXXXXXXXXXXXXXXXX##XXXXXXXX..............................................
........######.....XXXXXXXXXXXXXXXXXXXXXXXXXXXXXX######.............................................
........######....XXXXX##XXXXXXXXXXXXXXXXXXXXXXXX######XXXX.XX......................................
.................XXXXXX##XXXXXXXXXXXXXX....X.XXXXXXXXXX.XXXXX.................##....................
..................XXXXX##XXXXXXXXXXX.XX......XXXXXXXXXXXXXXXXX................##....................
...........######..XXXX##XXXXXXXXXXXXXXXXX...X.XXXXXXXXXXXXXXX.X..............##.............##.....
...........######..XXXX##XXXXX######XXXXXXX..XXXXXXXXXXXXXXXX..X..............##.............##.....
...................XXXX##XXXXX######XXXXXXX...XXXXXXXXXXXXXXXXX...............##.............##.....
...................XXXXXXXXXXXXXXXXXXXXXXXXXXXXXX######XXXXXXXX...............##.............##.....
....................X.XXXXXXXXXXXXXXXXXXXXXX..XXX######XXXXXXX...............................##.....
........................XXXXXXXXXXXXXXXXXXXX..XXXXXXXXXXXXXXXX...............................##.....
.##......................XXXXXXXXXXXXXXXXXXXXXXXXXX######XXXXXX...................######XX.X...X.XX.
.##......................XXXXXXXXXXXXXXXXXXXXXXXXXX######XXXX.....................######XX.XX.X.X.X.
.##.......................XXXXXXXX######XXXXXXXXXXXXXXXXXXXXX.....................X.XXXXXXXXXXXXXX..
.##........................XXXXXXX######XXXXXXXXXXXXXXXXXXXXX.....................XXXXXXXXXXXXXX.X..
.##.........................XXXXXXXXXXXXXXXXXXXXX######XXXXXXX....................XXXXXXXXXXXXXXXXX.
X##X........................XXXXXXXXXXXXXXXXXXXXX######XXXXXXX...................XXXXXXXXXXXX##XXXX.
XXX...XXX....................XXXXXXXXXXXXXXXXXXXXXXXXXXXXXXXXXXXX.................XXXXXXXXXXX##XXXX.
XXXXXXXXX...................XXXXXXXXXXXXXXXXXXXXXXXXXXXXXXXXXXX...................XXXXXXXXXXX##XXXX.
XXXXXXXXX....................XX.XXXXXXXXXXXXXXXXXXXXXXXXXXXXXXXXX................XX##XXXXXXXX##XXXX.
XXXXXXXXX.........................XXXXXXXXXXXXXXXXXXXXXXXXXXXXXXX................XX##XXXXXXXX##XXXX.
XXXXXXXXX...........................XXXXXXXXXXXXXXXXXXX######XXXXX................X##XXXXXXXX##XXXX.
XXXXXXXXX...............................XXXXXXXXXXXXXXX######XXXXXX.............XXX##XXXXXXXXXXXXXX.
XXXXXXXXX..............................XXXXXXXXXXXXXXXXXXXXXXXXXXXX.............XXX##XXXXXXXXXXXXXX.
XXXXXXXXX..............................XXXXXXXXXXXXXXXXXXXXXXXXXXXX..............XX##XXXXXXXXXXXXXX.
XXXXXXXXX...............................XXXXXXXXXXXXXXXXXXXXXXXXXXX.........66666666666666AXXXXXXXX.
XXXXXXXXX..............................XXXXXXXXXXX##XXXXXXXXXXXXXXX.........6...XXXXXXXXXXXXXXXXXXXX
XXXXXXX.................................XXXXXXXXXX##XXXXXXXXXXXXXXX.........6.....XXXXXXXXXXXXXXXXXX
XXXXXX.XX.................................XXXXXXXX##XXXXXXXXXXXXXXX.........6....XXXXXXXXXXXXXXXXXXX
XXXXXX.....................................XXXXXXX##XXXXXXXXXXXXXX..........6......XXXXXXXXXXXXXXXX.
XXXX.........................................XXXXX##XXXXXXXXXXXXX...........6.......XXXXXXXXXXXXXXX.
.............................................XX.XX##XXXXXXXXXXXX............6.......XXXX.XXXXXXXXX..
................................................XXX##XXXX.XXXX..............6.......XXXXXXXXXXXXXX..
.................................................X.##X......................6...................XXX.
...................................................##.......................6...................XXX.
...................................................##.......................6...................XXX.
...................................................##.......................6.......................
...................................................##.......................6.......................
............................................................................6.......................
............................................................................6.......................
..........................................................................##6.......................
..............................................######...##.................##6.......................
..............................................######...##.................##6.......................
.......................................................##.................##6.......................
.......................................................##.................##6.......................
.........##............................................##..XXXX.XX..X.....##A.......................
.........##............................................##XXXX.XXXXXXX...######......................
.........##............................................XXXXX.XXXXXXXXX..######......................
.........##...........................................XXXXXXXXXXXXXXX...............................
.........##...........................................XXXXXXX##XXXXXXX..............................
.........##...........................................XXXXXXX##XXXXXXX..............................
......................................................XXXXXXX##XXXXXXX..............................
......................................................XXXXXXX##XXXXXXX..............................
.......................................................XXXXXX##XX.XX...............##...............
...........................................######.....XXXXXXX##XXX.X...............##...............
...........................................######.....XXXXXXXXXXXXX................##...............
..........................................................XXXXXXX..................##...............
...................................................................................##...............
.................######........................######...............##.............##...............
.................######........................######.....##........##..............................
..........................................................##........##..............................
..........................................................##........##......######..................
.............................#######......................##........##......######..................
.............................#######......................#######...##...........444A.######........
.............................##..A0.......................#######...............44....######........
.............................##...0.........................................44444...................
.............................##...000000....................................4.......................
.............................##........0.......................##...........4.......................
.......................................00......................##...........4.......................
........................................0......................##...........4.......................
........................................000000.................##...........4.......................
.....######..................................00................##...........4.......................
.....######.......######......................000..............##...........4.......................
..................######........................0000........................4.......................
................######.............................0........................4.......................
......##....##########.............................000......................4.......................
......##....######...................................000....................4.......................
......##...............................................0....................4.......................
......##...............................................000..................4.......................
......##.................................................00.................4.......................
......##..............................##..................0.................4.......................
......................................##..................00................4.......................
......................................##...................00000............4.............######....
......................................##.......................0............A.............######....
......................................##..######...............00.........######....................
......................................##..######................00........######....................
........................................................##.......0......######......................
##.....................................................######....0......######......................
##.....................................................######....00000..............................
##......................................................###..........0..............................
##..............................##......................###..........0A##...........................
##...................######.....##......................###.......#######...........................
##...................######.##..A#.......................##.......#######...........................
............................##..##.......................##............##...........................
............................##..##.....................................##...........................
..............######........##..##...........##........................##..##.......................
..............######........##...............##............................##.......................
............................##..............A##..................111111111A#T................##.....
............................................5##..................1......##.##...######.......##.....
............................................5##..................A......##.##...######.......##.....
........................................55555##.........................##.##................##.....
.......................................55...............................##...................##.....
.......................................5................................####.................##.....
.##..................................555..............................######........................
.##................................555................................##..##........................
.##...........................555555..................................##..##........................
.##..................######...5............................######.....##..##........................
.##..................######..55............................#############..##........................
.##......................55555...........................##.....########......##....................
........................55...............................##...................##....................
........................5................................##...................##....................
.......................A5................................##...............##..##....................
................##.......................................##...............##..##....................
................##......##...............................##...............##..##....................
................##......##................................................##........................
................##......##................................................##........................
................##......##................................................##........................
................##......##..........................................................................
........................##.............................................................##...........
.......................................................................................##...........
......................................................XXXXXXX..X.XX....................##...........
...XXXXXXXXXX.X..X..............##########..........XXXXXXXXXXXXXX.....................##...........
..X.XXXXXXXXXXXXXX..............##########........XXXXXXXXXXXXXXXX.....................##...........
..XXXXXXXXXXXXXXXX................................XXXXXXXXXXXXXXXX.....................##...........
..XXX##XXXXXXXXXX...................................XXXXXXXXXXXXX...................................
..XXX##XXXXXXXXXX##.......................######....XXXXXXXXXXXX######..............................
.X..X##XXXXXXXXXX##.......................######...XXXXXXXXXXXXX######..............................
..XXX##XXXX.XXX..##.......................##.........X..XXXXXXX.....................................
.X.XX##XXXXXXXXXX##.......................##.......XXXXXXXXXXXXX.X..................................
.XXXX##XXXXXXXXXX##.......................##......XXX.XXXXXXXXXXXX..................................
.XXX.XXXXXXXXXXX.##.......................##......XX..XXXXXXXXXX.X...........................XX.....
.............................................................XX.............................XXXX....

