.................X.XX........................XXXXXXXXXXX.......XXXXXXXXXXX.
..................XXXX.X.....................XXXXXXXXXXX.........XXXXXXX.X.
...................XXX..........................XXXXXXX.........X.XX.XXXX..
....................XXX.......................XXXXXXXXXX.........XXX..XX...
....................XXX.......................XXXXXXXXXXX............XXXX..
...............................................XXXXXXXXX.X............XXX..
..............................................X.XXXXXXXXXX..X.X..........X.
..............................................XXXX...XXXXXXXXXXX...........
..............................................XXX.X....X..XX.XX............
.........................................................XXXXX.XXXX........
.......................................XXXX..X..............XXXXX.XXX......
.......................................XXXX.XXX.............XXXX.XXXX.X....
..................XXX..XXXX.XXX........XXXXXXXXX...................XXXX....
..................X.XXXX..XXXXX.........XXXXXXXXX..................XXXX....
..................XXXXXXXXXXXXX..X.........XXXXX..X...................X..XX
...........XXXXXX.XXXXXXXXXXXXXXX.X..........XXXX......................X...
............XX.XXXXXXXXXXXXXXXXXX.X..........XXXXX......................XX.
...........XXXXXXXXXXXXXXXXXXXXXXXXXXX.XXXXXXXXXXX..XXX..XXX.............XX
XXX..........XXXXXXXXXXXXXXXXXXXXXXXXXXXXX.XXXXXXXXXXXXXXXXX..............X
X.X.........XXXXXXXXXXXXXXXXXXXXXXXXXXXXXXXXXXXXXXXXX.XXXXXX...............
XXX.........XXXXXXXXXXXXXXXXXXXXXXXXXXXXXX.XXXXXXXXXXXXXXX.X...............
XXX.........XXXXXXXXXXXXXXXXXXXXXXXXXXXXXXXXXXXXXXXXXXXXXXXX...............
XXX..........XXXXXXXXXXXXXXXXXXXXXXXXX.XXXXXXXXXXXXXXXXXXXXX...............
..............XXXXXXXXXXXXXXXXXXXXXXXXXXXXXXXXXXXXXXXXXXXXXX...............
.............XXXXXXXXXXXXXXXXXXXXXXXXXXXXXXXXXXXXXXXXXXXXXXXX..............
...............X.XXXXXXXXXXXXXXXXXXXXXXXXXXXXXXXXXXXXXXXXXXXX..............
................XXXXXXXXXXXXXXXXXXXXXXXXXXXXXXXXXXXXXXXXXXXXXX.............
...............XXXXXXXXXXXXXXXXXXXXXXXXXXXXXXXXXXXXXXXXXXXXXXX.............
................XXXXXXXXXXXXXXXXXXXXXXXXXXXXXXXXXXXXXXXXXXXXX..............
..................XXXXXXXXXXXXXXXXXXXXX.XXXXXXXXXXXXXXXXXXXXXX.............
...................X.XXXXXXXXXXXXXXXXXXXXXXXXXXXXXXXXXXXXXXXX..............
.....................XXXXXXXXXXXXXXXXXXXXXXXXXXXXXXXXXXXXXXXXX.............
......................XXX.XXXXXXX......XXXXXXXXXXXXXXXXXXXXXXX.............
........................................XXXXXXXXXXXXXXXXXXXXXX.............
.......................................XXXXXXXXXXXXXXXXXXXXXXX.............
........................................XXXXXXXXXXXXXXXXXXXX...............
........................................X.XXXXXXXXXXX......................
...........XX..............................................................
...........XX..............................................................
.........XXXXX.............................................................
.........XXXX.......X..XXXXXXXXXXXXXXXXXXXX.X..............................
.........XXXX.X...XXXXXXXXXXXXXXXXXXXXXXXXXX.X.............................
...........XXXX..XXXXXXXXXXXXXXXXXXXXXXXXXXXXX...XXXX.X....................
...........XXXX...XXXXXXXXXXXXXXXXXXXXXXXXXXXX.X..XXXX.....................
..........XX.XX.X.XXXXXXXXXXXXXXXXXXXXXXXXX.XXXXXXXXXX.....................
...........XXXXXX.XXXXXXXXXXXXXXXXXXXXXXXXXXX.XXXXXXXX.....................
......XXXX....XXXX.XXXXXXXXXXXXXXXXXXXXXXXXXXXXXXXXXXXX....................
....XXX.X........XXXXXXXXXXXXXXXXXXXXXXXXXXXXX..XXXXXX.....................
...XXXXXXX...X.X.XXXXXXXXXXXXXXXXXXXXXXXXXXXXX...................X....X....
....XXXXX......X.XXXXXXXXXXXXXXXXXXXXXXXXXXXXX.X.....X...........XXXXXXX...
...XXXXXX.....XXXXXXXXXXXXXXXXXXXXXXXXXX.XXXXXXX..................X.X.XXXXX
.................XXXXXXXXXXXXXXXXXXXXXXXXXXX.XXX...XX.............XXXXXXXXX
.................X.XXXXXXXXXXXXXXXXXXXXX.XXXXXXX........X.X.......XXXXXXX..
........X.X.......XXXXXXXXXXXXX.............XXXX.......X..XX.X...X..XX..XXX
.....XXXXX....................X.......................X.XXXX.XXX.XXXXX.XXXX
......XXXXX............................................XXXXXXX.XXXX..XXXX..
....X.XXXX.............................................XXXXXXXX.XXXXXX.XX..
.....X.X.XX..........................................XXXXX..XXX.X.XXXXXXX..
......XXXXXXXX.......................................XXXXXXXX..XXXX.XXXXXX.
.........XXXX.........................................XXX.......XXX.XXXXXX.
..........XXX.........................................XXXX.........X.XXXXX.
............X...........................................XX.X.........XXXXXX
.........XXXX.........................................X.XXXX.........XXXXXX
........XXXXX.........................................XXXXXXX........XXXXXX
X.XXX..XXXXX.........................................X.XXXXX.........XX.XXX
XXXXX....XXX..........................................XXXXXX..........XXXX.
XXXX.............................................XX.XXXX.XX................
X.XX......XXX....................................XXX.XXX.X......XX.........
XXXX.X.....X.X..................................XXXXXXXX...XX.XXX.........X
XXXXXXXX...XXX....................................X.X.XXXXXXXXXXXXX...X.XXX
XXXXXXX.X..XXX..................................X.X.XXXXXXXXXXXXX.XX......X
XXXX.XXX....XXX...................................XX.XXXXX.XXXXXXXX......X.
...XXXXX..XXXX...................................X.XXXXXXXXXXXXXX..........
..XXXXXXX..XXXXX..................................XXXXXX.XXXXXXXXX.........
...XXX...........X..................................X........XXXX..XX......

