XXXXXXXXXXXXXXXXXXXXXXXX..XXXXXXXXXXXXXXXXXXXX............XXXXXXXXXXXXXXXX.
XXXXXXXXXXXXXXXXX######XXXXXXXXXXXXXXXXXXXXXX.............XXXXXXXXXXXXXXXX.
XXXXXXX........XX######XXXXXXXXXXXXXXXXXXXXXXXX............XXXXXXXXXXXXXXXX
XXXXXXXX...............XXXXXXXXXXXXXXXXXXXXXXXXXXXXX......XXXXXXXXXXXXXXXXX
XXXX##XX..............XXXXXXXXXXXXXXXXXXXXXXXXXXXXXX.......XXXXXXXXXXXXXXXX
XXXX##X................XXXXXXXXXXXXXXXXXXXXXXXXXXXXX........XXXXXXXXXXXXXXX
XXXX##................XXXXXXXXXXXXXXXXXXXXXXXXXXXXXX.......##X.XXXXXXXXXXXX
XXXX##X...............XXXXXXXXXXXXXXXXXXXXXXXXXXXXX........##XXXXXXXXXXXXXX
XXXX##X................XXXXXXXXXXXXXXXXXXXXXXXXXXXX........##..XXXXX.XXXXX.
XXXX##X.........######XXXXXXXXXXXXXXXXXXXXXXXXXXX..........##..XXXXXXXXXXX.
XXXXXX.##.......######XXXXXXXXXXXXXXXXXXXXXXXXXXXXX........##..XXXXXXXXXXXX
XXXX.X.##...............XXXXXXXXXXXXXXXXXXXXXXXXX..........##...XXXXXXXXXXX
XXX.XX.##..............X..X##XXXXXXXX..XXXXXXXX............##.XXXXXXXXXXXXX
XXXXXX.##...............XXX##XXXXXXXX......................##..XXXXXXXXXXX.
XXXXXX.##................XX##XXXXXXXXX.........................XXXXXXXXXXX.
XXXXX..##................X.##X..X.X.............................XXXXXXXXXXX
XXXX.......................##.................................X..XXXXXXXXX.
XX.........................##....................................X...XXXXXX
X......................................................................XXX.
.......................................................................XX..
.........##.............................................................X..
.........##......######....................................................
.........##......######....................................................
..XX.XXXX##XXXX..............................######........................
..XXXXXXX##XXXX..............................######........................
..XXXXXXX##XXX.XX..........................................................
.XXXXXXXXXXXXXXX...................................................######..
.XXXXXXXXXXXXXXXXXXX...............................................######..
XXXXXXXXXXXXXXXXXXXX........................##.............................
XXXXXXXXXXXXXXXXXXX.........................##.............................
XXXXXXXXXXXXXXXXXXXX........................##.......####......######......
X..XXXXXXXXXXXXXXXX.........................##.......####......########....
XXXXXXXXXXXXXXX.XX..........................##.......####........######....
.XXXXXXXXXXXXXXXXX..........................##.......######................
.XXXXXXXXXXXXXXXX..........................########..######................
..XX.XXXXXXXXX.............................########..######................
XXXXXXXXXXXXXXXXXXX..............................##..##..##................
.XXXXXXXXXXXXXXXX................................##..##..##................
...XX.XXXXXXXXX..................................##..##..##................
.................................................##..##....................

