XXXXXXXXXXXXXXXXXXXXXXXXXXX.............
XXX.XXXXXXXXXXXXXXXXXXXXXX..............
XXX.X.XXXXXXXXXXXXXX.X.X................
X.......XXXXXXXXXX..................XXXX
X.XX....XX.XXX.XXXX..................XXX
XXXXXXXX.X.XX.XXX.....................X.
XXXXXXXXX.X..XXXXX.........X........X...
XXXXXXXXXXXXX...X.........X.XX.XXXXX.XXX
XXXXXXXXXXXXX..............XXXXXXXXXXXXX
XXXXXXXXXXX..XXX............X.XXXXXX..XX
XXXXXXXXXXXXXXX..X.X.......XXXXXXXXX....
XXXXXXXXXXXXXXXXX.XXXX......XXXXXXXX...X
XXXX.X.XXXXXXXXX..XXX.......X.XXXXX.X...
X..XX.......XXXXX.XXXX.....XXX.XX...XX..
XXXXXXXXXX.......X..XX.X...............X
XXXXXXXXXX.......XXXXXX..............XXX
XXXXXXXX........XXXX........X...X.X....X
XXXXXXXXXXX....XXXXX.............XX.....
...XXX........XXXXX..............XXXX...
....XXX.......XX..................XXX...

