.....................XXXXXXXXXXXXXXXXXXXXXXXXXXXXXXXXXXXXXXXXXXXXXXXXXXXXX.
......................XXXXXXXXXXXXXXXXXXXXXXXXXXXXXXXXXXXXXXXXXXXXXXXXXXXX.
......................XXXXXXXXXXXXXXXXXXXXXXXXXXXXXXXXXXXXXXXXXXXXXXXXXXXX.
......................XXXXXXXXXXXXXXXXXXXXXXXXXXXXXXXXXXXXXXXXXXXXXXXXXXXX.
......................XXXXXXXXXXXXXXXXXXXXXXXXXXXXXXXXXXXXXXXXXXXXXXXXXXXX.
.........##............XXXXXXXXXXXXXXXXXXXXXXXXXXXXXXXXXXXXXXXXXXXXXXXXXXX.
.........##......................XXXXXXXXXXXXXXXXXXXXXXXXXXXXXXXXXXXXXXXXX.
.........##......................XXXXXXXXXXXXXXXXXXXXXXXXXXXXXXXXX.X...XXX.
.........##......................XXXXXXXXXXXXXXXXXXXXXXXXXXXXXXXXXX....XX..
.........##......................XXXXXXXXXXXXXXXXXXXXXXXXXXXXXXXXXXXXX..X..
.........##......................X##XXXXXXXXXXXXXXXXXXXXXXXXXXXXXXXXXX.....
..................................##XXXXXXXXXXXXXXXXXXXXXXXXXXXXXX.XXXXX...
......................######......##.XXXXXXXXXXXXXXXXXXXXXXXXXXXXXXXXXX....
......................######......##..XXXXXXXXXXXXX##XXXXXXXXXXXXXXXXXX....
..................................##...XXXXXXXXXXXX##XXXXXXXXXXXXXXXXXX....
..................................##........XXXXXXX##XXXXXXXXXXXXXXXXX.X...
..........................................XXXXX######XXXXXXXXXXXXXXX.XXX...
............................................XXX######XXXXXXXXXXXXXXXX......
##........................................XX.XXXXXX##XXXXXXXXXXXXXXX######.
##...............##.......................X.XXXXXXXXXXXXXXXXXXXXXXXX######.
##..........##...##.......................X.XX##XXXXXXXXXXXXXXXXXX.........
##..........##...##.......................######XXXXXX##.X.................
##.....##...##...##................##.....######XXXXXX##...................
##....###...##...##................##........X##XXXXX.##.........##........
......###...##...##................##......##.##......##.........##........
X..XX.###...##.....................##......##.##......##.........##........
XXXXXX###XX........................##......##.....######.........##........
XXXXXX###X..X......................##..##..##.....######.........##........
XXXXXX##XXXX.X.........................##..##....................##........
XXXXXXXXXXX######......................##..##........##....................
XXXXXXXXXXX######......................##............##....................
XXXXXXXXXXXXXX.........................##............##....................
XXXXXXXXXXXXXX.........................##............##....................
XXXXXXXXX##XX........................................##....................
XXXXXXXXX##XXXX.......##.............................##....................
XXXXXXXXX##XXXXXX.X...##......######.......................................
XXXXXXXXX#######X.X.####......######.......................................
XXXXXXXXX#######XXX.####...................................................
XXXXXXXXX##XXXXXXX..#######................................................
XXXXXXXXXXXXXXXXXXX.#######................................................
XXXXXXXXXXXXXXXXX##.##..##....##.........######............................
XXXXXXXXXXXXXXXXX##X##..##....##.........######............................
XXXXXXXXXXXXXXXXX##.XX..##....##...........................................
XXXX######XXXXXXX##XXXXX##XX..##...........................................
XXXX######XXXXXXX##XXXXXXXX.XX##...........................................
XXXXXXXXXXXXXXXXX##XXXXXXXXXXX##...........................................
XXXXXXXXXXXXXXX######XXXXXXXX.X............................................
XXXXXXXXXXXXXXX#########XXXXXX...............X.XXXXXXXXXXXX.XXX.X.XX...XX..
XXXXXXXXXXXXXXXXXX######XXXXX.X..............XXXXXXXXXX##XXXXXXXX.XX.XXX...
XXXX######XXXXXXXXXXXXXXXXXXX.X......######...XXXXXXXXX##XXXXXXXXXXXXXXXX..
XXXX######XXXXXXXXXXXXXXXXXXX........######.XXXXXXXXXXX##XXXXXXXXXXXXXXXXX.
.XXXXXXXXXXXXXXXXXXXXXXXXXX.................XXXXXXXXXXX##XXXXXXXXXXXXXXXX..
XXXXXXXXXXXXXXXXXXXXXXXX................######XXXXXXXXX##XXXXXXXXXXXXXXXX..
XXXXXXXXXXXXXXXXXXXXX...................######XXXXXXXXX##XXXXXXXXXXXXXXXXX.
XXXXXXXXXXXXXX##XXXX........................XXXXXXXXXXXXXXXXXXXXXXXXXXXXXXX
XXXXXXXXXXXXXX##XXXX........................X..XXXXXXXXXXXXXXXXXXXXXXXXXXX.
XXXXXXXXX#######XXX.XXXX.......................XXXXXXXXXXXXXXXXXXXXXXXXXXX.
XXXXXXXXX#######XXXXXXX..X.....................XXXXXXXXXXXXXXXXXXXXXXXXXXX.
XXXXXXXXXXXXXX##XXXXXXXXX......................X.XXXXXXXXXXXXXXXXXXXXXXXXX.
XXXXXXXXXXXXXX##XXXXXXXXX........................X.XXXXXXXXXXXXXXXXXXXXXXX.
XXXXXXXXXXXXXXXXXXXXXX.XXX........................X..XXXXXXXXXXXXXXXXXXXXXX
XXXXXXXXXXXXXXXXXXXXXXXXXX..................XXX.XXXXXXXXXXXXXXXXXXXXX##XXXX
XXXXXXXXXXXXXXXXXXXXXXXXXX..................XXXXXXXXXXXXXXXXXXXXXXXXX##XXXX
XXXXXXXXXXXXXXXXXXXXXXXXXX..................XX.XXXXXXXXX##XXXXXXXXXXX##XXX.
XXXXXXXX..XXXXXXXXXXXXXX....................XXXXXXXXXXXX##XXXXXXXXXXX##XXX.
XXXXXXXX..XXXXXXXXXXXXX....................XXXXXXXXXXXXX##XXXXXXXXXXX##XXX.
X##XX.X....X.XXXXXXXXX.....................XXXXXXXXXXXXX##XXXXXXXXXXX##XXX.
X##X...........................######......##XXXXXXXXXXX##XXXXXXXXXXXX.XXXX
X##............................######......##XXXXXXXXXXX##XXXXXXXXXXXX.XXXX
.##...........................##...........##XXXXXXXXXXXXXXXXXXXXXXX.X.XX..
.##...........................##...........##X.XXXXXX..XXXXXXXXXXXXX.......
X##XX.........................##...........##XXXXXXXXXXXXXXXXXXXXXXXXXX....
..............................##...........##XXXXXXXXXXX.XXXXXXXXXXXXX.....
..............................##.............XXXXXXXXXXXXXXXXXXXXXXXX......
..............................##.......................X........XXXX.......

