..XX...XX...........
.XXXX.##########.XX.
.XAXAA#A########XX..
..0AAAX3333ATAAA.X..
.....222222AA..1....
....XAX.....777A....
.....XXX.X........X.
......XXXXX....X.XXX
.......XXX.........X
........X........X.X

