..XX...XX...........
.XXXX.##########.XX.
.XXXX.##########XX..
....X.X..........X..
....................
....XXX.............
.....XXX.X........X.
......XXXXX....X.XXX
.......XXX.........X
........X........X.X

