##########.XXXXX.XXXX...................
....X...##########......................
..XX.XXXX...XXXXXXX.....................
..X.X.XX....X.XXXXX.....................
..X.XXXX..........X.X...................
.X.X............XXXXXX.33A..............
.XXXX.............333333................
XXXXX............X3XX...................
.X.XXX.##########.3.....................
..................3.....X...............
..................3....XX..X............
.................#3......XX.X...........
XX...............#3....XXXXXX...........
XX...............#A.....XXXX............
XXX......##########......XXXX......X....
X................#......XXXXX.....5.XXXX
.................#...00..XXXX555555X.XXX
..1..............#XXX0.555555577777X...X
..11111111.......#555555XXXXX.7XXXX..XXX
...2XX..X1.......#5XX..XXX..777..X....X.
..X2X.X.X1111....#57777777777...........
...2XXXX.XX.1111115XXXX.XX..............
...2222222222222225.XXXXXX..............
...XXX.XXXXXXXXXX.5XXXXX................
.......XXXXXXX..X45XXXXX................
........XXXXXXXXXXA66666666666666666....
...........XXXXXXXXX.XXX...........66...
...........X.XXXX...X...................
............XXXXX..X.X..................
........................................

