...XXX.X.#XXXXXXX##########.............
.........#.X.XXXXXX.....................
.........#XXXXXXXX........X.............
.........#..X.XXXX..........XX.......X.X
.........#...XXXXXX....##########..X.XX.
.........#....XXXXX......#.............X
.........#....XXXX.......#.............X
X..X.....#..XXXXXXX......#.....1111.....
..XXX....#...XXXX.X......#........1.....
XXX......#...XXXXX.......#........1.....
XXXX.........XXXXX.......#........1.....
XXXX.........XXXX.......X#.X......1.....
XXXXX.......00000....X...#.X......1.....
.XXXX.......XXXX00......X#X......21.....
X.XXX..XX...X....0....XX..........1.....
.XXXXXXXX.XXX.X..000000000000.....1.....
XXX.X.XX...XXX..............A.....A...XX
.....XX....XXX..........................
.....XX......XX.........................
........................................

