...XXX.X.#XXXXXXX##########.............
.........#.X.XXXXXX.....................
.........#XXXXXXXX........X.............
.........#..X.XXXX..........XX.......X.X
.........#...XXXXXX....##########..X.XX.
.........#....XXXXX......#.............X
.........#....XXXX.......#.............X
X..X.....#..XXXXXXX......#..............
..XXX....#...XXXX.X......#..............
XXX......#...XXXXX.......#..............
XXXX.........XXXXX.......#..............
XXXX.........XXXX.......X#.X............
XXXXX.........XX.....X...#.X............
.XXXX.......XXXX........X#X.............
X.XXX..XX...X.........XX................
.XXXXXXXX.XXX.X.........X...............
XXX.X.XX...XXX........................XX
.....XX....XXX..........................
.....XX......XX.........................
........................................

