##########.XXXXX.XXXX...................
....X...##########......................
..XX.XXXX...XXXXXXX.....................
..X.X.XX....X.XXXXX.....................
..X.XXXX..........X.X...................
.X.X............XXXXXX..................
.XXXX.............XXXXX.................
XXXXX............XXXX...................
.X.XXX.##########.......................
........................X...............
.......................XX..X............
.................#.......XX.X...........
XX...............#.....XXXXXX...........
XX...............#......XXXX............
XXX......##########......XXXX......X....
X................#......XXXXX.......XXXX
.................#.......XXXX..XXX.X.XXX
.................#XXX....XXXX..XXX.X...X
.................#X.....XXXXX..XXXX..XXX
...XXX..X........#.XX..XXX.......X....X.
..X.X.X.X........#XXX..XXX..............
....XXXX.XX.......XXXXX.XX..............
....XXXXXXXX......X.XXXXXX..............
...XXX.XXXXXXXXXX.XXXXXX................
.......XXXXXXX..XXXXXXXX................
........XXXXXXXXXXXXXXXX................
...........XXXXXXXXX.XXX................
...........X.XXXX...X...................
............XXXXX..X.X..................
........................................

