..#....XXXXXXX.XXXXXXX..................
.X#.XXXXXX...X.XXXXXX...................
.X#XXX.......X.XXXXXXX..................
.X#XXXX...#...XXXXX......##########.....
..#XX.X...#...XXXXX.....................
..#.XX..##########......................
..#.....A2#XX.XX........................
..#......2#XXXXX.............X.X......X.
..#......A#XXXX.............XX.......X..
..#.A0000A#XXXX...X.XX......XXT......XXX
......111A#XXXX....X..X...XXXXX........X
.....A1...#X..X..XXXXXXX...X.XX........X
.......XXX#..X...XXXXXX......XXX...XXXX.
........XXX........XXXX............X.XX.
..X.XXX............XXXX............XXXXX
.....X..........................X..X.XXX
..XXXX........................X....X.XX.
................................X.......
.XXX............................XX......
...X....................................

