#....XXXXX..........
#....XXXX..XXXXXXXXX
#.A..X##########.XXX
#.55AAATXXA2....XXXX
#...XXXAAA.22A......
#..AAXXA.66666......
#..AAA77.....6A.....
#..........XX.......
#..........XX.......
#...................

