#....XXXXX..........
#....XXXX..XXXXXXXXX
#....X##########.XXX
#......XXX......XXXX
#...XXX.............
#....XX.............
#...................
#..........XX.......
#..........XX.......
#...................

